Parte 1

E|----------------------------------------------------|
B|----------------------------------------------------|
G|-1--1--1------1h2p1---------------------------------|
D|----------4----------4------------------------------|
A|----------------------------------------------------|
E|----------------------------------------------------|


Parte 2

E|----------------------------------------------------|
B|----------------------------------------------------|
G|-1--1--1------1h2p1-----1---------------------------|
D|----------4----------4------------------------------|
A|----------------------------------------------------|
E|----------------------------------------------------|

Parte 3

E|----------------------------------------------------|
B|----------------------------------------------------|
G|-1--1--1-----------1--------------------------------|
D|----------4--4--4-----------------------------------|
A|----------------------------------------------------|
E|----------------------------------------------------|