Parte 1

E|----------------------------------------------------|
B|----------------------------------------------------|
G|----------------1--2--4-----------------------------|
D|-------1--2--4--------------------------------------|
A|-2--4-----------------------------------------------|
E|----------------------------------------------------|

Parte 2

E|----------------------------------------------------|
B|----------------------------------------------------|
G|----------------------------------------------------|
D|-------------------1--2-----------------------------|
A|----------0--2--4-----------------------------------|
E|-0--2--4--------------------------------------------|