Nirvana - The Man Who Sold The World

[Solo 2] G#  C#m  E  C#m (2x)
         G#  C#m  E

E|----------------------------------------------------|
B|----------------------------------------------------|
G|-1/8----8--8----8--8--8--8----8--8----8--8--8-------|
D|----------------------------------------------------|
A|----------------------------------------------------|
E|----------------------------------------------------|

E|----------------------------------------------------|
B|----------------------------------------------------|
G|-1--1--1------1h2p1-----1--1--1---------------------|
D|----------4----------4-----------4------------------|
A|----------------------------------------------------|
E|----------------------------------------------------|

E|----------------------------------------------------|
B|----------------------------------------------------|
G|-1/9----9--9----9--9--9--9----9--9----9--9\8--8\6---|
D|----------------------------------------------------|
A|----------------------------------------------------|
E|----------------------------------------------------|

E|----------------------------------------------------|
B|----------------------------------------------------|
G|-6----6--6--6--6----6--6----6--6--6---6/8-----------|
D|----------------------------------------------------|
A|----------------------------------------------------|
E|----------------------------------------------------|

E|----------------------------------------------------|
B|----------------------------------------------------|
G|-8--8----8--8--8--8----8--8----8--8--8--------------|
D|----------------------------------------------------|
A|----------------------------------------------------|
E|----------------------------------------------------|

E|----------------------------------------------------|
B|----------------------------------------------------|
G|-1--1--1------1h2p1-----1--1--1---------------------|
D|----------4----------4-----------4------------------|
A|----------------------------------------------------|
E|----------------------------------------------------|

E|----------------------------------------------------|
B|----------------------------------------------------|
G|-1/9----9--9----9--9--9--9----9--9----9--9\11--8-6--|
D|----------------------------------------------------|
A|----------------------------------------------------|
E|----------------------------------------------------|

Parte 8 de 11

E|----------------------------------------------------|
B|----------------------------------------------------|
G|-6----6--6--6--6----6--6----6--6--6---6/8-----------|
D|----------------------------------------------------|
A|----------------------------------------------------|
E|----------------------------------------------------|

E|----------------------------------------------------|
B|----------------------------------------------------|
G|-8--8----8--8--8--8----8--8----8--8--8--------------|
D|----------------------------------------------------|
A|----------------------------------------------------|
E|----------------------------------------------------|

E|----------------------------------------------------|
B|----------------------------------------------------|
G|-1--1--1------1h2p1---------------------------------|
D|----------4----------4------------------------------|
A|----------------------------------------------------|
E|----------------------------------------------------|

E|----------------------------------------------------|
B|----------------------------------------------------|
G|-1--1--1------1h2p1-----1---------------------------|
D|----------4----------4------------------------------|
A|----------------------------------------------------|
E|----------------------------------------------------|

